[
"1J","0E","1C","1E","1G","1G","1H","1D","1D","1E","1G","1G","1H","1D","1D","1E",
"27","0E","20","22","24","24","25","21","21","22","24","24","25","21","21","22",
"00","00","00","00","00","00","00","00","00","00","00","00","00","00","00","00",
"00","00","00","00","00","00","00","00","00","00","00","00","00","00","00","00",
"00","00","00","00","00","00","00","00","00","00","00","00","00","00","00","00",
"00","00","00","00","00","00","00","00","00","00","00","00","00","00","00","00",
"00","00","00","00","00","00","00","00","00","00","00","00","00","00","00","00",
"00","00","00","00","00","00","00","00","00","00","00","00","00","00","00","00",
"00","00","00","00","00","00","00","00","00","00","00","00","00","00","00","00"
]
